"","ï..sample_id","Strain","Salt","A","C","total","Dispersed","CI","participation"
"1",1,"PS312","NH4Br",11,0,11,32,1,0.255813953488372
"2",2,"PS312","NH4Br",9,1,10,40,0.8,0.2
"3",3,"PS312","NH4Br",42,7,49,107,0.714285714285714,0.314102564102564
"4",4,"PS312","NH4Br",33,9,42,90,0.571428571428571,0.318181818181818
"5",5,"PS312","NH4Br",13,0,13,95,1,0.12037037037037
"6",6,"PS312","NH4Br",28,11,39,47,0.435897435897436,0.453488372093023
"7",7,"PS312","NH4Br",25,10,35,61,0.428571428571429,0.364583333333333
"8",8,"PS312","NH4Br",36,15,51,43,0.411764705882353,0.542553191489362
"9",9,"PS312","NH4Br",44,13,57,55,0.543859649122807,0.508928571428571
"10",10,"PS312","NH4Br",18,11,29,34,0.241379310344828,0.46031746031746
"11",11,"PS312","NH4Br",61,33,94,23,0.297872340425532,0.803418803418803
"12",12,"PS312","NH4Br",53,13,66,39,0.606060606060606,0.628571428571429
"13",13,"PS312","NH4Br",31,16,47,38,0.319148936170213,0.552941176470588
"14",14,"PS312","NH4Br",36,6,42,36,0.714285714285714,0.538461538461538
"15",15,"PS312","NH4Br",42,19,61,72,0.377049180327869,0.458646616541353
"16",16,"PS312","NH4Br",42,19,61,91,0.377049180327869,0.401315789473684
"17",17,"PS312","NH4Br",25,18,43,53,0.162790697674419,0.447916666666667
"18",18,"PS312","NH4Br",68,29,97,91,0.402061855670103,0.515957446808511
"19",19,"PS312","NH4Br",35,14,49,103,0.428571428571429,0.322368421052632
"20",20,"PS312","NH4Br",73,11,84,99,0.738095238095238,0.459016393442623
"21",21,"PS312","NH4Br",45,18,63,96,0.428571428571429,0.39622641509434
"22",22,"PS312","NH4Br",37,28,65,19,0.138461538461538,0.773809523809524
"23",23,"PS312","NH4Br",25,27,52,19,-0.0384615384615385,0.732394366197183
"24",24,"PS312","NH4Br",44,25,69,31,0.27536231884058,0.69
"25",25,"PS312","NH4Br",29,7,36,18,0.611111111111111,0.666666666666667
"26",26,"PS312","NH4Br",26,5,31,10,0.67741935483871,0.75609756097561
"27",27,"PS312","NH4Br",13,9,22,14,0.181818181818182,0.611111111111111
"28",28,"PS312","NH4Br",24,4,28,82,0.714285714285714,0.254545454545455
"29",29,"PS312","NH4Br",16,5,21,79,0.523809523809524,0.21
"30",30,"PS312","NH4Br",40,9,49,81,0.63265306122449,0.376923076923077
"31",31,"PS312","NH4Br",62,18,80,111,0.55,0.418848167539267
"32",32,"PS312","NH4Br",93,20,113,129,0.646017699115044,0.466942148760331
"33",33,"PS312","NH4Br",56,20,76,124,0.473684210526316,0.38
"34",34,"PS312","NH4Br",23,13,36,25,0.277777777777778,0.590163934426229
"35",35,"PS312","NH4Br",26,13,39,46,0.333333333333333,0.458823529411765
"36",36,"PS312","NH4Br",17,13,30,28,0.133333333333333,0.517241379310345
"37",37,"PS312","NH4Br",20,16,36,42,0.111111111111111,0.461538461538462
"38",38,"PS312","NH4Br",26,41,67,43,-0.223880597014925,0.609090909090909
"39",39,"PS312","NH4Br",44,49,93,65,-0.0537634408602151,0.588607594936709
"40",40,"PS312","NH4Br",12,0,12,NA,1,NA
"41",41,"PS312","NH4Br",29,5,34,NA,0.705882352941177,NA
"42",42,"PS312","NH4Br",27,3,30,NA,0.8,NA
"43",43,"PS312","NH4Br",13,3,16,NA,0.625,NA
"44",44,"PS312","NH4Br",27,5,32,NA,0.6875,NA
"45",45,"PS312","NH4Br",9,5,14,36,0.285714285714286,0.28
"46",46,"PS312","NH4Br",31,4,35,65,0.771428571428571,0.35
"47",47,"PS312","NH4Br",28,9,37,52,0.513513513513513,0.415730337078652
"48",48,"PS312","NH4Br",189,81,270,167,0.4,0.617848970251716
"49",49,"PS312","NH4Br",157,41,198,169,0.585858585858586,0.539509536784741
"50",50,"PS312","NH4Br",17,14,31,48,0.0967741935483871,0.392405063291139
"51",51,"PS312","NH4Br",50,28,78,94,0.282051282051282,0.453488372093023
"52",52,"PS312","NH4Br",9,2,11,17,0.636363636363636,0.392857142857143
"53",53,"PS312","NH4Br",8,3,11,15,0.454545454545455,0.423076923076923
"54",54,"PS312","NH4Br",7,3,10,10,0.4,0.5
"55",55,"PS312","NH4Br",7,2,9,9,0.555555555555556,0.5
"56",56,"PS312","NH4Br",39,8,47,78,0.659574468085106,0.376
"57",57,"PS312","NH4Br",79,8,87,39,0.816091954022989,0.69047619047619
"58",58,"PS312","NH4Br",37,6,43,43,0.720930232558139,0.5
"59",59,"PS312","NH4Br",26,17,43,81,0.209302325581395,0.346774193548387
"60",60,"PS312","NH4Br",37,16,53,90,0.39622641509434,0.370629370629371
"61",61,"PS312","NH4Br",26,6,32,45,0.625,0.415584415584416
"62",62,"PS312","NH4Br",27,8,35,66,0.542857142857143,0.346534653465347
"63",63,"PS312","NH4Br",33,12,45,58,0.466666666666667,0.436893203883495
"64",64,"PS312","NH4Br",12,4,16,45,0.5,0.262295081967213
"65",65,"PS312","NH4Br",6,13,19,30,-0.368421052631579,0.387755102040816
"66",66,"PS312","NH4Br",13,7,20,70,0.3,0.222222222222222
"67",67,"PS312","NH4Br",42,5,47,73,0.787234042553192,0.391666666666667
"68",68,"PS312","NH4Br",54,15,69,98,0.565217391304348,0.413173652694611
"69",69,"PS312","NH4Br",62,13,75,90,0.653333333333333,0.454545454545455
"70",70,"PS312","NH4Br",46,13,59,49,0.559322033898305,0.546296296296296
"71",71,"PS312","NH4Br",27,6,33,63,0.636363636363636,0.34375
"72",72,"PS312","NH4Br",14,5,19,45,0.473684210526316,0.296875
"73",73,"PS312","NH4Br",14,3,17,47,0.647058823529412,0.265625
"74",74,"PS312","NH4Br",18,20,38,68,-0.0526315789473684,0.358490566037736
"75",75,"PS312","NH4Br",32,11,43,63,0.488372093023256,0.405660377358491
"76",76,"PS312","NH4Br",30,18,48,68,0.25,0.413793103448276
"77",77,"PS312","NH4Br",24,20,44,60,0.0909090909090909,0.423076923076923
"78",78,"PS312","NH4Br",11,5,16,50,0.375,0.242424242424242
"79",79,"PS312","NH4Br",68,30,98,120,0.387755102040816,0.44954128440367
"80",80,"PS312","NH4Br",67,22,89,109,0.50561797752809,0.44949494949495
"81",81,"PS312","NH4Br",70,15,85,80,0.647058823529412,0.515151515151515
"82",82,"PS312","NH4Br",19,5,24,61,0.583333333333333,0.282352941176471
"83",83,"PS312","NH4Br",29,8,37,52,0.567567567567568,0.415730337078652
"84",84,"PS312","NH4Br",25,9,34,51,0.470588235294118,0.4
"85",85,"csu79","NH4Br",47,0,47,80,1,0.37007874015748
"86",86,"csu79","NH4Br",7,3,10,87,0.4,0.103092783505155
"87",87,"csu79","NH4Br",15,3,18,69,0.666666666666667,0.206896551724138
"88",88,"csu79","NH4Br",12,1,13,76,0.846153846153846,0.146067415730337
"89",89,"csu79","NH4Br",11,1,12,57,0.833333333333333,0.173913043478261
"90",90,"csu79","NH4Br",15,0,15,23,1,0.394736842105263
"91",91,"csu79","NH4Br",27,3,30,39,0.8,0.434782608695652
"92",92,"csu79","NH4Br",10,1,11,38,0.818181818181818,0.224489795918367
"93",93,"csu79","NH4Br",14,2,16,36,0.75,0.307692307692308
"94",94,"csu79","NH4Br",17,1,18,72,0.888888888888889,0.2
"95",95,"csu79","NH4Br",14,2,16,35,0.75,0.313725490196078
"96",96,"csu79","NH4Br",10,1,11,39,0.818181818181818,0.22
"97",97,"csu79","NH4Br",11,1,12,55,0.833333333333333,0.17910447761194
"98",98,"csu79","NH4Br",14,2,16,54,0.75,0.228571428571429
"99",99,"csu79","NH4Br",12,0,12,53,1,0.184615384615385
"100",100,"csu79","NH4Br",12,1,13,26,0.846153846153846,0.333333333333333
"101",101,"csu80","NH4Br",38,3,41,90,0.853658536585366,0.312977099236641
"102",102,"csu80","NH4Br",89,17,106,117,0.679245283018868,0.475336322869955
"103",103,"csu80","NH4Br",135,21,156,121,0.730769230769231,0.563176895306859
"104",104,"csu80","NH4Br",142,37,179,147,0.58659217877095,0.549079754601227
"105",105,"csu80","NH4Br",90,17,107,73,0.682242990654206,0.594444444444444
"106",106,"csu80","NH4Br",74,19,93,130,0.591397849462366,0.417040358744395
"107",107,"csu80","NH4Br",21,5,26,80,0.615384615384615,0.245283018867925
"108",108,"csu80","NH4Br",18,20,38,43,-0.0526315789473684,0.469135802469136
"109",109,"csu80","NH4Br",33,12,45,37,0.466666666666667,0.548780487804878
"110",110,"csu80","NH4Br",2,10,12,37,-0.666666666666667,0.244897959183673
"111",111,"csu80","NH4Br",20,32,52,68,-0.230769230769231,0.433333333333333
"112",112,"csu80","NH4Br",37,44,81,61,-0.0864197530864197,0.570422535211268
"113",113,"csu80","NH4Br",19,34,53,94,-0.283018867924528,0.360544217687075
"114",114,"csu80","NH4Br",27,4,31,50,0.741935483870968,0.382716049382716
"115",115,"csu80","NH4Br",20,1,21,16,0.904761904761905,0.567567567567568
"116",116,"csu80","NH4Br",21,3,24,25,0.75,0.489795918367347
"117",117,"csu80","NH4Br",29,6,35,32,0.657142857142857,0.522388059701492
"118",118,"csu80","NH4Br",25,1,26,21,0.923076923076923,0.553191489361702
"119",119,"csu80","NH4Br",33,3,36,13,0.833333333333333,0.73469387755102
"120",120,"csu80","NH4Br",38,6,44,58,0.727272727272727,0.431372549019608
"121",121,"csu80","NH4Br",27,17,44,43,0.227272727272727,0.505747126436782
"122",122,"csu80","NH4Br",24,6,30,34,0.6,0.46875
"123",123,"csu80","NH4Br",30,10,40,70,0.5,0.363636363636364
"124",124,"csu80","NH4Br",33,8,41,72,0.609756097560976,0.36283185840708
"125",125,"csu80","NH4Br",23,7,30,35,0.533333333333333,0.461538461538462
"126",126,"csu80","NH4Br",26,7,33,30,0.575757575757576,0.523809523809524
"127",127,"csu80","NH4Br",33,11,44,39,0.5,0.530120481927711
"128",128,"csu80","NH4Br",37,15,52,30,0.423076923076923,0.634146341463415
"129",129,"csu80","NH4Br",52,16,68,25,0.529411764705882,0.731182795698925
"130",130,"csu80","NH4Br",46,18,64,33,0.4375,0.65979381443299
"131",131,"csu80","NH4Br",32,9,41,35,0.560975609756098,0.539473684210526
"132",132,"csu80","NH4Br",32,12,44,46,0.454545454545455,0.488888888888889
"133",133,"csu80","NH4Br",14,10,24,38,0.166666666666667,0.387096774193548
"134",134,"csu80","NH4Br",18,7,25,32,0.44,0.43859649122807
"135",135,"csu80","NH4Br",16,12,28,35,0.142857142857143,0.444444444444444
"136",136,"csu80","NH4Br",21,9,30,57,0.4,0.344827586206897
"137",137,"csu80","NH4Br",15,6,21,42,0.428571428571429,0.333333333333333
"138",138,"che-1 #1","NH4Br",10,8,18,78,0.111111111111111,0.1875
"139",139,"che-1 #1","NH4Br",21,8,29,59,0.448275862068966,0.329545454545455
"140",140,"che-1 #1","NH4Br",22,9,31,67,0.419354838709677,0.316326530612245
"141",141,"che-1 #1","NH4Br",6,6,12,77,0,0.134831460674157
"142",142,"che-1 #1","NH4Br",58,17,75,111,0.546666666666667,0.403225806451613
"143",143,"che-1 #1","NH4Br",71,12,83,90,0.710843373493976,0.479768786127168
"144",144,"che-1 #1","NH4Br",34,17,51,102,0.333333333333333,0.333333333333333
"145",145,"che-1 #1","NH4Br",41,21,62,100,0.32258064516129,0.382716049382716
"146",146,"che-1 #1","NH4Br",88,72,160,160,0.1,0.5
"147",147,"che-1 #1","NH4Br",83,39,122,127,0.360655737704918,0.48995983935743
"148",148,"che-1 #1","NH4Br",147,90,237,130,0.240506329113924,0.645776566757493
"149",149,"che-1 #1","NH4Br",96,53,149,130,0.288590604026846,0.53405017921147
"150",150,"che-1 #2","NH4Br",9,7,16,23,0.125,0.41025641025641
"151",151,"che-1 #2","NH4Br",6,4,10,12,0.2,0.454545454545455
"152",152,"che-1 #2","NH4Br",8,2,10,18,0.6,0.357142857142857
"153",153,"che-1 #2","NH4Br",8,6,14,60,0.142857142857143,0.189189189189189
"154",154,"che-1 #2","NH4Br",9,6,15,36,0.2,0.294117647058824
"155",155,"che-1 #2","NH4Br",18,5,23,53,0.565217391304348,0.302631578947368
"156",156,"che-1 #2","NH4Br",34,11,45,90,0.511111111111111,0.333333333333333
"157",157,"che-1 #2","NH4Br",31,12,43,63,0.441860465116279,0.405660377358491
"158",158,"che-1 #2","NH4Br",27,10,37,53,0.459459459459459,0.411111111111111
"159",159,"che-1 #2","NH4Br",17,6,23,52,0.478260869565217,0.306666666666667
"160",160,"che-1 #2","NH4Br",21,3,24,45,0.75,0.347826086956522
"161",161,"che-1 #2","NH4Br",21,4,25,44,0.68,0.36231884057971
"162",162,"mok83","NH4Br",22,14,36,47,0.222222222222222,0.433734939759036
"163",163,"mok83","NH4Br",29,11,40,43,0.45,0.481927710843373
"164",164,"mok83","NH4Br",11,9,20,22,0.1,0.476190476190476
"165",165,"mok83","NH4Br",21,10,31,34,0.354838709677419,0.476923076923077
"166",166,"mok83","NH4Br",3,7,10,33,-0.4,0.232558139534884
"167",167,"mok83","NH4Br",9,5,14,50,0.285714285714286,0.21875
"168",168,"mok83","NH4Br",9,5,14,43,0.285714285714286,0.245614035087719
"169",169,"mok83","NH4Br",9,5,14,29,0.285714285714286,0.325581395348837
"170",170,"mok83","NH4Br",26,5,31,37,0.67741935483871,0.455882352941176
"171",171,"mok83","NH4Br",15,5,20,40,0.5,0.333333333333333
"172",172,"mok83","NH4Br",11,9,20,35,0.1,0.363636363636364
"173",173,"mok84","NH4Br",11,10,21,19,0.0476190476190476,0.525
"174",174,"mok84","NH4Br",11,6,17,26,0.294117647058824,0.395348837209302
"175",175,"mok84","NH4Br",20,5,25,28,0.6,0.471698113207547
"176",176,"mok84","NH4Br",12,11,23,43,0.0434782608695652,0.348484848484849
"177",177,"mok84","NH4Br",9,5,14,42,0.285714285714286,0.25
"178",178,"mok84","NH4Br",18,13,31,36,0.161290322580645,0.462686567164179
"179",179,"mok84","NH4Br",14,12,26,34,0.0769230769230769,0.433333333333333
"180",180,"mok84","NH4Br",18,7,25,39,0.44,0.390625
"181",181,"mok84","NH4Br",25,17,42,42,0.19047619047619,0.5
"182",182,"mok84","NH4Br",20,12,32,35,0.25,0.477611940298507
"183",183,"mok84","NH4Br",9,3,12,25,0.5,0.324324324324324
"184",184,"mok59","NH4Br",14,7,21,41,0.333333333333333,0.338709677419355
"185",185,"mok59","NH4Br",8,9,17,36,-0.0588235294117647,0.320754716981132
"186",186,"mok59","NH4Br",21,20,41,92,0.024390243902439,0.308270676691729
"187",187,"mok59","NH4Br",8,12,20,41,-0.2,0.327868852459016
"188",188,"mok59","NH4Br",9,5,14,35,0.285714285714286,0.285714285714286
"189",189,"mok59","NH4Br",11,9,20,50,0.1,0.285714285714286
"190",190,"mok59","NH4Br",9,8,17,44,0.0588235294117647,0.278688524590164
"191",191,"mok59","NH4Br",8,7,15,25,0.0666666666666667,0.375
"192",192,"mok59","NH4Br",4,6,10,60,-0.2,0.142857142857143
"193",193,"mok59","NH4Br",9,10,19,42,-0.0526315789473684,0.311475409836066
"194",194,"mok59","NH4Br",11,7,18,48,0.222222222222222,0.272727272727273
"195",195,"mok59","NH4Br",10,10,20,44,0,0.3125
"196",196,"PS312","NH4Cl",39,13,52,65,0.5,0.444444444444444
"197",197,"PS312","NH4Cl",40,11,51,37,0.568627450980392,0.579545454545455
"198",198,"PS312","NH4Cl",37,7,44,62,0.681818181818182,0.415094339622642
"199",199,"PS312","NH4Cl",45,13,58,23,0.551724137931034,0.716049382716049
"200",200,"PS312","NH4Cl",71,48,119,131,0.19327731092437,0.476
"201",201,"PS312","NH4Cl",35,20,55,50,0.272727272727273,0.523809523809524
"202",202,"PS312","NH4Cl",58,33,91,97,0.274725274725275,0.484042553191489
"203",203,"PS312","NH4Cl",13,3,16,62,0.625,0.205128205128205
"204",204,"PS312","NH4Cl",9,1,10,63,0.8,0.136986301369863
"205",205,"PS312","NH4Cl",19,14,33,71,0.151515151515152,0.317307692307692
"206",206,"PS312","NH4Cl",6,4,10,32,0.2,0.238095238095238
"207",207,"PS312","NH4Cl",32,2,34,58,0.882352941176471,0.369565217391304
"208",208,"PS312","NH4Cl",10,5,15,42,0.333333333333333,0.263157894736842
"209",209,"PS312","NH4Cl",24,6,30,47,0.6,0.38961038961039
"210",210,"PS312","NH4Cl",74,38,112,162,0.321428571428571,0.408759124087591
"211",211,"PS312","NH4Cl",39,25,64,102,0.21875,0.385542168674699
"212",212,"PS312","NH4Cl",20,19,39,102,0.0256410256410256,0.276595744680851
"213",213,"PS312","NH4Cl",31,19,50,90,0.24,0.357142857142857
"214",214,"PS312","NH4Cl",15,9,24,53,0.25,0.311688311688312
"215",215,"PS312","NH4Cl",18,3,21,NA,0.714285714285714,NA
"216",216,"PS312","NH4Cl",15,3,18,29,0.666666666666667,0.382978723404255
"217",217,"PS312","NH4Cl",18,5,23,24,0.565217391304348,0.48936170212766
"218",218,"PS312","NH4Cl",10,9,19,27,0.0526315789473684,0.41304347826087
"219",219,"PS312","NH4Cl",28,14,42,66,0.333333333333333,0.388888888888889
"220",220,"PS312","NH4Cl",11,6,17,25,0.294117647058824,0.404761904761905
"221",221,"PS312","NH4Cl",44,23,67,77,0.313432835820896,0.465277777777778
"222",222,"PS312","NH4Cl",74,18,92,69,0.608695652173913,0.571428571428571
"223",223,"PS312","NH4Cl",17,11,28,31,0.214285714285714,0.474576271186441
"224",224,"PS312","NH4Cl",48,17,65,87,0.476923076923077,0.427631578947368
"225",225,"PS312","NH4Cl",37,26,63,35,0.174603174603175,0.642857142857143
"226",226,"PS312","NH4Cl",32,18,50,22,0.28,0.694444444444444
"227",227,"PS312","NH4Cl",34,23,57,52,0.192982456140351,0.522935779816514
"228",228,"PS312","NH4Cl",16,11,27,17,0.185185185185185,0.613636363636364
"229",229,"PS312","NH4Cl",30,14,44,22,0.363636363636364,0.666666666666667
"230",230,"PS312","NH4Cl",35,12,47,19,0.48936170212766,0.712121212121212
"231",231,"PS312","NH4Cl",64,16,80,79,0.6,0.50314465408805
"232",232,"PS312","NH4Cl",72,23,95,117,0.515789473684211,0.44811320754717
"233",233,"PS312","NH4Cl",42,32,74,127,0.135135135135135,0.368159203980099
"234",234,"PS312","NH4Cl",42,26,68,84,0.235294117647059,0.447368421052632
"235",235,"PS312","NH4Cl",12,6,18,45,0.333333333333333,0.285714285714286
"236",236,"PS312","NH4Cl",13,8,21,29,0.238095238095238,0.42
"237",237,"PS312","NH4Cl",11,6,17,25,0.294117647058824,0.404761904761905
"238",238,"PS312","NH4Cl",24,10,34,86,0.411764705882353,0.283333333333333
"239",239,"PS312","NH4Cl",30,12,42,79,0.428571428571429,0.347107438016529
"240",240,"PS312","NH4Cl",16,7,23,22,0.391304347826087,0.511111111111111
"241",241,"PS312","NH4Cl",26,9,35,49,0.485714285714286,0.416666666666667
"242",242,"PS312","NH4Cl",15,4,19,19,0.578947368421053,0.5
"243",243,"PS312","NH4Cl",14,9,23,32,0.217391304347826,0.418181818181818
"244",244,"PS312","NH4Cl",17,3,20,29,0.7,0.408163265306122
"245",245,"PS312","NH4Cl",27,7,34,60,0.588235294117647,0.361702127659574
"246",246,"PS312","NH4Cl",7,3,10,57,0.4,0.149253731343284
"247",247,"PS312","NH4Cl",31,6,37,101,0.675675675675676,0.268115942028986
"248",248,"PS312","NH4Cl",25,0,25,96,1,0.206611570247934
"249",249,"PS312","NH4Cl",17,1,18,63,0.888888888888889,0.222222222222222
"250",250,"PS312","NH4Cl",37,9,46,81,0.608695652173913,0.362204724409449
"251",251,"PS312","NH4Cl",71,21,92,108,0.543478260869565,0.46
"252",252,"PS312","NH4Cl",37,14,51,77,0.450980392156863,0.3984375
"253",253,"PS312","NH4Cl",34,15,49,63,0.387755102040816,0.4375
"254",254,"PS312","NH4Cl",45,21,66,97,0.363636363636364,0.404907975460123
"255",255,"PS312","NH4Cl",10,7,17,44,0.176470588235294,0.278688524590164
"256",256,"PS312","NH4Cl",21,11,32,52,0.3125,0.380952380952381
"257",257,"PS312","NH4Cl",31,16,47,50,0.319148936170213,0.484536082474227
"258",258,"PS312","NH4Cl",30,24,54,48,0.111111111111111,0.529411764705882
"259",259,"PS312","NH4Cl",27,23,50,45,0.08,0.526315789473684
"260",260,"PS312","NH4Cl",37,7,44,76,0.681818181818182,0.366666666666667
"261",261,"PS312","NH4Cl",42,10,52,56,0.615384615384615,0.481481481481481
"262",262,"PS312","NH4Cl",30,7,37,64,0.621621621621622,0.366336633663366
"263",263,"PS312","NH4Cl",40,5,45,58,0.777777777777778,0.436893203883495
"264",264,"PS312","NH4Cl",13,6,19,23,0.368421052631579,0.452380952380952
"265",265,"PS312","NH4Cl",24,6,30,31,0.6,0.491803278688525
"266",266,"PS312","NH4Cl",14,10,24,24,0.166666666666667,0.5
"267",267,"PS312","NH4Cl",32,7,39,39,0.641025641025641,0.5
"268",268,"PS312","NH4Cl",47,13,60,81,0.566666666666667,0.425531914893617
"269",269,"PS312","NH4Cl",34,10,44,44,0.545454545454545,0.5
"270",270,"PS312","NH4Cl",10,5,15,19,0.333333333333333,0.441176470588235
"271",271,"PS312","NH4Cl",9,4,13,19,0.384615384615385,0.40625
"272",272,"PS312","NH4Cl",39,20,59,46,0.322033898305085,0.561904761904762
"273",273,"PS312","NH4Cl",20,10,30,38,0.333333333333333,0.441176470588235
"274",274,"csu79","NH4Cl",22,1,23,29,0.91304347826087,0.442307692307692
"275",275,"csu79","NH4Cl",12,1,13,27,0.846153846153846,0.325
"276",276,"csu79","NH4Cl",23,2,25,104,0.84,0.193798449612403
"277",277,"csu79","NH4Cl",33,0,33,51,1,0.392857142857143
"278",278,"csu79","NH4Cl",13,1,14,75,0.857142857142857,0.157303370786517
"279",279,"csu79","NH4Cl",11,1,12,32,0.833333333333333,0.272727272727273
"280",280,"csu79","NH4Cl",43,16,59,196,0.457627118644068,0.231372549019608
"281",281,"csu79","NH4Cl",29,2,31,127,0.870967741935484,0.19620253164557
"282",282,"csu79","NH4Cl",21,0,21,76,1,0.216494845360825
"283",283,"csu79","NH4Cl",21,0,21,91,1,0.1875
"284",284,"csu79","NH4Cl",7,3,10,13,0.4,0.434782608695652
"285",285,"csu79","NH4Cl",8,4,12,15,0.333333333333333,0.444444444444444
"286",286,"csu79","NH4Cl",6,3,9,20,0.333333333333333,0.310344827586207
"287",287,"csu80","NH4Cl",12,4,16,29,0.5,0.355555555555556
"288",288,"csu80","NH4Cl",19,8,27,33,0.407407407407407,0.45
"289",289,"csu80","NH4Cl",30,13,43,86,0.395348837209302,0.333333333333333
"290",290,"csu80","NH4Cl",19,7,26,69,0.461538461538462,0.273684210526316
"291",291,"csu80","NH4Cl",72,32,104,203,0.384615384615385,0.338762214983713
"292",292,"csu80","NH4Cl",73,22,95,187,0.536842105263158,0.336879432624113
"293",293,"csu80","NH4Cl",122,56,178,247,0.370786516853933,0.418823529411765
"294",294,"csu80","NH4Cl",102,60,162,110,0.259259259259259,0.595588235294118
"295",295,"csu80","NH4Cl",20,3,23,65,0.739130434782609,0.261363636363636
"296",296,"csu80","NH4Cl",18,4,22,67,0.636363636363636,0.247191011235955
"297",297,"csu80","NH4Cl",9,5,14,52,0.285714285714286,0.212121212121212
"298",298,"csu80","NH4Cl",14,4,18,38,0.555555555555556,0.321428571428571
"299",299,"csu80","NH4Cl",9,4,13,93,0.384615384615385,0.122641509433962
"300",300,"csu80","NH4Cl",60,16,76,165,0.578947368421053,0.315352697095436
"301",301,"csu80","NH4Cl",76,15,91,172,0.67032967032967,0.346007604562738
"302",302,"csu80","NH4Cl",82,26,108,176,0.518518518518518,0.380281690140845
"303",303,"csu80","NH4Cl",62,11,73,176,0.698630136986301,0.293172690763052
"304",304,"che-1 #1","NH4Cl",16,11,27,80,0.185185185185185,0.252336448598131
"305",305,"che-1 #1","NH4Cl",9,1,10,71,0.8,0.123456790123457
"306",306,"che-1 #1","NH4Cl",10,7,17,79,0.176470588235294,0.177083333333333
"307",307,"che-1 #1","NH4Cl",6,5,11,63,0.0909090909090909,0.148648648648649
"308",308,"che-1 #1","NH4Cl",7,4,11,38,0.272727272727273,0.224489795918367
"309",309,"che-1 #1","NH4Cl",7,9,16,86,-0.125,0.156862745098039
"310",310,"che-1 #1","NH4Cl",48,41,89,143,0.0786516853932584,0.383620689655172
"311",311,"che-1 #1","NH4Cl",32,24,56,133,0.142857142857143,0.296296296296296
"312",312,"che-1 #1","NH4Cl",14,18,32,87,-0.125,0.26890756302521
"313",313,"che-1 #1","NH4Cl",47,54,101,194,-0.0693069306930693,0.342372881355932
"314",314,"che-1 #1","NH4Cl",27,20,47,105,0.148936170212766,0.309210526315789
"315",315,"che-1 #2","NH4Cl",15,7,22,178,0.363636363636364,0.11
"316",316,"che-1 #2","NH4Cl",30,24,54,102,0.111111111111111,0.346153846153846
"317",317,"che-1 #2","NH4Cl",17,5,22,174,0.545454545454545,0.112244897959184
"318",318,"che-1 #2","NH4Cl",28,18,46,133,0.217391304347826,0.256983240223464
"319",319,"che-1 #2","NH4Cl",7,10,17,80,-0.176470588235294,0.175257731958763
"320",320,"che-1 #2","NH4Cl",7,3,10,81,0.4,0.10989010989011
"321",321,"che-1 #2","NH4Cl",5,5,10,47,0,0.175438596491228
"322",322,"che-1 #2","NH4Cl",9,4,13,38,0.384615384615385,0.254901960784314
"323",323,"che-1 #2","NH4Cl",8,3,11,39,0.454545454545455,0.22
"324",324,"che-1 #2","NH4Cl",15,6,21,78,0.428571428571429,0.212121212121212
"325",325,"che-1 #2","NH4Cl",8,7,15,65,0.0666666666666667,0.1875
"326",326,"che-1 #2","NH4Cl",14,12,26,83,0.0769230769230769,0.238532110091743
"327",327,"che-1 #2","NH4Cl",14,13,27,73,0.037037037037037,0.27
"328",328,"che-1 #2","NH4Cl",15,30,45,94,-0.333333333333333,0.323741007194245
"329",329,"che-1 #2","NH4Cl",22,18,40,109,0.1,0.268456375838926
"330",330,"che-1 #2","NH4Cl",22,15,37,98,0.189189189189189,0.274074074074074
"331",331,"che-1 #2","NH4Cl",26,17,43,100,0.209302325581395,0.300699300699301
"332",332,"mok83","NH4Cl",9,2,11,25,0.636363636363636,0.305555555555556
"333",333,"mok83","NH4Cl",7,4,11,26,0.272727272727273,0.297297297297297
"334",334,"mok83","NH4Cl",6,4,10,25,0.2,0.285714285714286
"335",335,"mok83","NH4Cl",3,5,8,14,-0.25,0.363636363636364
"336",336,"mok83","NH4Cl",12,6,18,43,0.333333333333333,0.295081967213115
"337",337,"mok83","NH4Cl",9,10,19,51,-0.0526315789473684,0.271428571428571
"338",338,"mok83","NH4Cl",11,5,16,26,0.375,0.380952380952381
"339",339,"mok83","NH4Cl",4,5,9,26,-0.111111111111111,0.257142857142857
"340",340,"mok83","NH4Cl",21,6,27,46,0.555555555555556,0.36986301369863
"341",341,"mok83","NH4Cl",22,12,34,45,0.294117647058824,0.430379746835443
"342",342,"mok83","NH4Cl",21,11,32,30,0.3125,0.516129032258065
"343",343,"mok83","NH4Cl",17,7,24,16,0.416666666666667,0.6
"344",344,"mok83","NH4Cl",15,10,25,34,0.2,0.423728813559322
"345",345,"mok83","NH4Cl",14,5,19,29,0.473684210526316,0.395833333333333
"346",346,"mok84","NH4Cl",10,12,22,42,-0.0909090909090909,0.34375
"347",347,"mok84","NH4Cl",11,12,23,39,-0.0434782608695652,0.370967741935484
"348",348,"mok84","NH4Cl",23,30,53,59,-0.132075471698113,0.473214285714286
"349",349,"mok84","NH4Cl",18,9,27,50,0.333333333333333,0.350649350649351
"350",350,"mok84","NH4Cl",14,14,28,54,0,0.341463414634146
"351",351,"mok84","NH4Cl",24,16,40,42,0.2,0.48780487804878
"352",352,"mok84","NH4Cl",19,14,33,60,0.151515151515152,0.354838709677419
"353",353,"mok84","NH4Cl",16,3,19,48,0.684210526315789,0.283582089552239
"354",354,"mok84","NH4Cl",36,6,42,48,0.714285714285714,0.466666666666667
"355",355,"mok84","NH4Cl",34,10,44,46,0.545454545454545,0.488888888888889
"356",356,"mok84","NH4Cl",38,17,55,67,0.381818181818182,0.450819672131148
"357",357,"mok84","NH4Cl",49,16,65,45,0.507692307692308,0.590909090909091
"358",358,"mok84","NH4Cl",27,7,34,38,0.588235294117647,0.472222222222222
"359",359,"mok84","NH4Cl",31,12,43,40,0.441860465116279,0.518072289156627
"360",360,"mok59","NH4Cl",10,10,20,37,0,0.350877192982456
"361",361,"mok59","NH4Cl",13,12,25,35,0.04,0.416666666666667
"362",362,"mok59","NH4Cl",10,12,22,40,-0.0909090909090909,0.354838709677419
"363",363,"mok59","NH4Cl",11,9,20,42,0.1,0.32258064516129
"364",364,"mok59","NH4Cl",6,5,11,25,0.0909090909090909,0.305555555555556
"365",365,"mok59","NH4Cl",5,12,17,31,-0.411764705882353,0.354166666666667
"366",366,"mok59","NH4Cl",6,3,9,13,0.333333333333333,0.409090909090909
"367",367,"mok59","NH4Cl",7,9,16,30,-0.125,0.347826086956522
"368",368,"mok59","NH4Cl",5,11,16,27,-0.375,0.372093023255814
"369",369,"mok59","NH4Cl",8,3,11,23,0.454545454545455,0.323529411764706
"370",370,"mok59","NH4Cl",7,9,16,42,-0.125,0.275862068965517
"371",371,"mok59","NH4Cl",8,8,16,48,0,0.25
"372",372,"PS312","NH4I",45,25,70,115,0.285714285714286,0.378378378378378
"373",373,"PS312","NH4I",68,12,80,131,0.7,0.37914691943128
"374",374,"PS312","NH4I",66,23,89,97,0.48314606741573,0.478494623655914
"375",375,"PS312","NH4I",22,10,32,67,0.375,0.323232323232323
"376",376,"PS312","NH4I",123,22,145,126,0.696551724137931,0.535055350553506
"377",377,"PS312","NH4I",138,35,173,90,0.595375722543353,0.657794676806084
"378",378,"PS312","NH4I",92,33,125,142,0.472,0.468164794007491
"379",379,"PS312","NH4I",58,31,89,172,0.303370786516854,0.340996168582375
"380",380,"PS312","NH4I",15,77,92,69,-0.673913043478261,0.571428571428571
"381",381,"PS312","NH4I",74,53,127,72,0.165354330708661,0.638190954773869
"382",382,"PS312","NH4I",66,46,112,103,0.178571428571429,0.52093023255814
"383",383,"PS312","NH4I",39,48,87,116,-0.103448275862069,0.428571428571429
"384",384,"PS312","NH4I",82,69,151,100,0.0860927152317881,0.601593625498008
"385",385,"PS312","NH4I",170,43,213,123,0.596244131455399,0.633928571428571
"386",386,"PS312","NH4I",72,37,109,89,0.321100917431193,0.55050505050505
"387",387,"PS312","NH4I",160,57,217,135,0.474654377880184,0.616477272727273
"388",388,"PS312","NH4I",105,35,140,115,0.5,0.549019607843137
"389",389,"PS312","NH4I",30,10,40,57,0.5,0.412371134020619
"390",390,"PS312","NH4I",11,6,17,29,0.294117647058824,0.369565217391304
"391",391,"PS312","NH4I",13,8,21,31,0.238095238095238,0.403846153846154
"392",392,"PS312","NH4I",46,5,51,36,0.803921568627451,0.586206896551724
"393",393,"PS312","NH4I",36,16,52,46,0.384615384615385,0.530612244897959
"394",394,"PS312","NH4I",45,36,81,70,0.111111111111111,0.536423841059603
"395",395,"PS312","NH4I",26,7,33,37,0.575757575757576,0.471428571428571
"396",396,"PS312","NH4I",37,10,47,63,0.574468085106383,0.427272727272727
"397",397,"PS312","NH4I",11,2,13,29,0.692307692307692,0.30952380952381
"398",398,"PS312","NH4I",35,9,44,51,0.590909090909091,0.463157894736842
"399",399,"PS312","NH4I",21,11,32,66,0.3125,0.326530612244898
"400",400,"PS312","NH4I",14,3,17,55,0.647058823529412,0.236111111111111
"401",401,"PS312","NH4I",15,4,19,33,0.578947368421053,0.365384615384615
"402",402,"PS312","NH4I",12,3,15,29,0.6,0.340909090909091
"403",403,"PS312","NH4I",19,5,24,30,0.583333333333333,0.444444444444444
"404",404,"PS312","NH4I",33,6,39,54,0.692307692307692,0.419354838709677
"405",405,"PS312","NH4I",55,8,63,84,0.746031746031746,0.428571428571429
"406",406,"PS312","NH4I",46,17,63,98,0.46031746031746,0.391304347826087
"407",407,"PS312","NH4I",39,14,53,87,0.471698113207547,0.378571428571429
"408",408,"PS312","NH4I",31,3,34,47,0.823529411764706,0.419753086419753
"409",409,"PS312","NH4I",40,4,44,79,0.818181818181818,0.357723577235772
"410",410,"PS312","NH4I",25,4,29,35,0.724137931034483,0.453125
"411",411,"PS312","NH4I",38,9,47,67,0.617021276595745,0.412280701754386
"412",412,"PS312","NH4I",31,8,39,83,0.58974358974359,0.319672131147541
"413",413,"PS312","NH4I",27,6,33,88,0.636363636363636,0.272727272727273
"414",414,"PS312","NH4I",42,7,49,107,0.714285714285714,0.314102564102564
"415",415,"PS312","NH4I",31,6,37,59,0.675675675675676,0.385416666666667
"416",416,"PS312","NH4I",18,10,28,59,0.285714285714286,0.32183908045977
"417",417,"PS312","NH4I",44,4,48,48,0.833333333333333,0.5
"418",418,"PS312","NH4I",38,8,46,51,0.652173913043478,0.474226804123711
"419",419,"PS312","NH4I",55,10,65,95,0.692307692307692,0.40625
"420",420,"PS312","NH4I",41,14,55,90,0.490909090909091,0.379310344827586
"421",421,"PS312","NH4I",21,9,30,40,0.4,0.428571428571429
"422",422,"PS312","NH4I",38,8,46,91,0.652173913043478,0.335766423357664
"423",423,"PS312","NH4I",32,8,40,51,0.6,0.43956043956044
"424",424,"PS312","NH4I",11,9,20,49,0.1,0.289855072463768
"425",425,"PS312","NH4I",27,2,29,56,0.862068965517241,0.341176470588235
"426",426,"PS312","NH4I",32,7,39,53,0.641025641025641,0.423913043478261
"427",427,"PS312","NH4I",19,3,22,35,0.727272727272727,0.385964912280702
"428",428,"PS312","NH4I",21,5,26,61,0.615384615384615,0.298850574712644
"429",429,"PS312","NH4I",23,14,37,43,0.243243243243243,0.4625
"430",430,"PS312","NH4I",29,7,36,72,0.611111111111111,0.333333333333333
"431",431,"PS312","NH4I",37,16,53,95,0.39622641509434,0.358108108108108
"432",432,"PS312","NH4I",39,30,69,106,0.130434782608696,0.394285714285714
"433",433,"csu79","NH4I",48,3,51,104,0.882352941176471,0.329032258064516
"434",434,"csu79","NH4I",33,1,34,73,0.941176470588235,0.317757009345794
"435",435,"csu79","NH4I",49,5,54,75,0.814814814814815,0.418604651162791
"436",436,"csu79","NH4I",20,4,24,51,0.666666666666667,0.32
"437",437,"csu79","NH4I",32,1,33,89,0.939393939393939,0.270491803278689
"438",438,"csu79","NH4I",47,5,52,88,0.807692307692308,0.371428571428571
"439",439,"csu79","NH4I",54,3,57,81,0.894736842105263,0.41304347826087
"440",440,"csu79","NH4I",21,1,22,70,0.909090909090909,0.239130434782609
"441",441,"csu79","NH4I",17,7,24,78,0.416666666666667,0.235294117647059
"442",442,"csu79","NH4I",37,2,39,80,0.897435897435897,0.327731092436975
"443",443,"csu79","NH4I",15,6,21,58,0.428571428571429,0.265822784810127
"444",444,"csu79","NH4I",48,0,48,111,1,0.30188679245283
"445",445,"csu79","NH4I",25,3,28,72,0.785714285714286,0.28
"446",446,"csu79","NH4I",17,1,18,27,0.888888888888889,0.4
"447",447,"csu79","NH4I",14,3,17,35,0.647058823529412,0.326923076923077
"448",448,"csu79","NH4I",30,3,33,35,0.818181818181818,0.485294117647059
"449",449,"csu79","NH4I",11,0,11,49,1,0.183333333333333
"450",450,"csu80","NH4I",73,5,78,56,0.871794871794872,0.582089552238806
"451",451,"csu80","NH4I",70,14,84,116,0.666666666666667,0.42
"452",452,"csu80","NH4I",47,16,63,50,0.492063492063492,0.557522123893805
"453",453,"csu80","NH4I",83,14,97,86,0.711340206185567,0.530054644808743
"454",454,"csu80","NH4I",52,50,102,156,0.0196078431372549,0.395348837209302
"455",455,"csu80","NH4I",89,56,145,137,0.227586206896552,0.514184397163121
"456",456,"csu80","NH4I",149,41,190,148,0.568421052631579,0.562130177514793
"457",457,"csu80","NH4I",76,30,106,160,0.433962264150943,0.398496240601504
"458",458,"csu80","NH4I",262,19,281,194,0.864768683274021,0.591578947368421
"459",459,"csu80","NH4I",203,56,259,143,0.567567567567568,0.644278606965174
"460",460,"csu80","NH4I",242,60,302,153,0.602649006622517,0.663736263736264
"461",461,"csu80","NH4I",180,28,208,153,0.730769230769231,0.57617728531856
"462",462,"csu80","NH4I",109,19,128,89,0.703125,0.589861751152074
"463",463,"csu80","NH4I",71,36,107,123,0.327102803738318,0.465217391304348
"464",464,"csu80","NH4I",154,33,187,152,0.647058823529412,0.551622418879056
"465",465,"csu80","NH4I",162,26,188,118,0.723404255319149,0.61437908496732
"466",466,"csu80","NH4I",127,26,153,101,0.660130718954248,0.602362204724409
"467",467,"che-1 #1","NH4I",61,13,74,87,0.648648648648649,0.459627329192547
"468",468,"che-1 #1","NH4I",83,19,102,110,0.627450980392157,0.481132075471698
"469",469,"che-1 #1","NH4I",75,36,111,97,0.351351351351351,0.533653846153846
"470",470,"che-1 #1","NH4I",52,29,81,98,0.283950617283951,0.452513966480447
"471",471,"che-1 #1","NH4I",36,13,49,84,0.469387755102041,0.368421052631579
"472",472,"che-1 #1","NH4I",60,27,87,126,0.379310344827586,0.408450704225352
"473",473,"che-1 #1","NH4I",33,21,54,76,0.222222222222222,0.415384615384615
"474",474,"che-1 #1","NH4I",36,9,45,63,0.6,0.416666666666667
"475",475,"che-1 #1","NH4I",32,16,48,76,0.333333333333333,0.387096774193548
"476",476,"che-1 #1","NH4I",41,13,54,60,0.518518518518518,0.473684210526316
"477",477,"che-1 #1","NH4I",27,7,34,55,0.588235294117647,0.382022471910112
"478",478,"che-1 #1","NH4I",25,10,35,80,0.428571428571429,0.304347826086957
"479",479,"che-1 #1","NH4I",24,3,27,33,0.777777777777778,0.45
"480",480,"che-1 #1","NH4I",8,0,8,40,1,0.166666666666667
"481",481,"che-1 #1","NH4I",31,0,31,24,1,0.563636363636364
"482",482,"che-1 #1","NH4I",8,1,9,24,0.777777777777778,0.272727272727273
"483",483,"che-1 #2","NH4I",137,84,221,200,0.239819004524887,0.524940617577197
"484",484,"che-1 #2","NH4I",145,54,199,189,0.457286432160804,0.512886597938144
"485",485,"che-1 #2","NH4I",163,69,232,218,0.405172413793103,0.515555555555556
"486",486,"che-1 #2","NH4I",80,31,111,104,0.441441441441441,0.516279069767442
"487",487,"che-1 #2","NH4I",30,11,41,74,0.463414634146341,0.356521739130435
"488",488,"che-1 #2","NH4I",36,19,55,74,0.309090909090909,0.426356589147287
"489",489,"che-1 #2","NH4I",64,35,99,64,0.292929292929293,0.607361963190184
"490",490,"che-1 #2","NH4I",45,7,52,66,0.730769230769231,0.440677966101695
"491",491,"che-1 #2","NH4I",17,9,26,51,0.307692307692308,0.337662337662338
"492",492,"che-1 #2","NH4I",30,11,41,70,0.463414634146341,0.369369369369369
"493",493,"che-1 #2","NH4I",31,13,44,61,0.409090909090909,0.419047619047619
"494",494,"che-1 #2","NH4I",35,13,48,51,0.458333333333333,0.484848484848485
"495",495,"che-1 #2","NH4I",31,10,41,54,0.51219512195122,0.431578947368421
"496",496,"che-1 #2","NH4I",8,0,8,34,1,0.19047619047619
"497",497,"che-1 #2","NH4I",19,3,22,37,0.727272727272727,0.372881355932203
"498",498,"che-1 #2","NH4I",8,2,10,36,0.6,0.217391304347826
"499",499,"mok83","NH4I",9,3,12,29,0.5,0.292682926829268
"500",500,"mok83","NH4I",12,10,22,48,0.0909090909090909,0.314285714285714
"501",501,"mok83","NH4I",9,1,10,27,0.8,0.27027027027027
"502",502,"mok83","NH4I",19,21,40,77,-0.05,0.341880341880342
"503",503,"mok83","NH4I",24,9,33,40,0.454545454545455,0.452054794520548
"504",504,"mok83","NH4I",15,10,25,49,0.2,0.337837837837838
"505",505,"mok83","NH4I",15,7,22,44,0.363636363636364,0.333333333333333
"506",506,"mok83","NH4I",21,13,34,55,0.235294117647059,0.382022471910112
"507",507,"mok83","NH4I",20,9,29,70,0.379310344827586,0.292929292929293
"508",508,"mok83","NH4I",34,6,40,48,0.7,0.454545454545455
"509",509,"mok83","NH4I",24,10,34,46,0.411764705882353,0.425
"510",510,"mok84","NH4I",12,7,19,42,0.263157894736842,0.311475409836066
"511",511,"mok84","NH4I",6,10,16,37,-0.25,0.30188679245283
"512",512,"mok84","NH4I",13,2,15,44,0.733333333333333,0.254237288135593
"513",513,"mok84","NH4I",12,5,17,31,0.411764705882353,0.354166666666667
"514",514,"mok84","NH4I",44,30,74,59,0.189189189189189,0.556390977443609
"515",515,"mok84","NH4I",55,24,79,55,0.392405063291139,0.58955223880597
"516",516,"mok84","NH4I",49,22,71,80,0.380281690140845,0.470198675496689
"517",517,"mok84","NH4I",43,18,61,70,0.409836065573771,0.465648854961832
"518",518,"mok84","NH4I",30,7,37,65,0.621621621621622,0.362745098039216
"519",519,"mok84","NH4I",32,10,42,44,0.523809523809524,0.488372093023256
"520",520,"mok84","NH4I",41,10,51,56,0.607843137254902,0.476635514018692
"521",521,"mok84","NH4I",31,9,40,63,0.55,0.388349514563107
"522",522,"mok59","NH4I",12,14,26,47,-0.0769230769230769,0.356164383561644
"523",523,"mok59","NH4I",12,14,26,48,-0.0769230769230769,0.351351351351351
"524",524,"mok59","NH4I",15,13,28,30,0.0714285714285714,0.482758620689655
"525",525,"mok59","NH4I",13,15,28,37,-0.0714285714285714,0.430769230769231
"526",526,"mok59","NH4I",5,6,11,22,-0.0909090909090909,0.333333333333333
"527",527,"mok59","NH4I",3,8,11,28,-0.454545454545455,0.282051282051282
"528",528,"mok59","NH4I",10,6,16,19,0.25,0.457142857142857
"529",529,"mok59","NH4I",7,4,11,21,0.272727272727273,0.34375
"530",530,"mok59","NH4I",10,4,14,20,0.428571428571429,0.411764705882353
"531",531,"mok59","NH4I",5,5,10,30,0,0.25
"532",532,"mok59","NH4I",5,4,9,25,0.111111111111111,0.264705882352941
"533",533,"mok59","NH4I",12,7,19,20,0.263157894736842,0.487179487179487
"534",534,"mok59","NH4I",7,7,14,31,0,0.311111111111111
"535",535,"PS312","LiCl",31,24,55,54,0.127272727272727,0.504587155963303
"536",536,"PS312","LiCl",27,16,43,37,0.255813953488372,0.5375
"537",537,"PS312","LiCl",28,23,51,114,0.0980392156862745,0.309090909090909
"538",538,"PS312","LiCl",22,12,34,42,0.294117647058824,0.447368421052632
"539",539,"PS312","LiCl",17,14,31,52,0.0967741935483871,0.373493975903614
"540",540,"PS312","LiCl",11,11,22,82,0,0.211538461538462
"541",541,"PS312","LiCl",7,12,19,46,-0.263157894736842,0.292307692307692
"542",542,"PS312","LiCl",23,23,46,38,0,0.547619047619048
"543",543,"PS312","LiCl",10,4,14,26,0.428571428571429,0.35
"544",544,"PS312","LiCl",9,14,23,68,-0.217391304347826,0.252747252747253
"545",545,"PS312","LiCl",18,55,73,92,-0.506849315068493,0.442424242424242
"546",546,"PS312","LiCl",16,24,40,83,-0.2,0.32520325203252
"547",547,"PS312","LiCl",29,46,75,97,-0.226666666666667,0.436046511627907
"548",548,"PS312","LiCl",26,55,81,73,-0.358024691358025,0.525974025974026
"549",549,"PS312","LiCl",24,28,52,57,-0.0769230769230769,0.477064220183486
"550",550,"PS312","LiCl",36,27,63,59,0.142857142857143,0.516393442622951
"551",551,"PS312","LiCl",60,29,89,90,0.348314606741573,0.497206703910615
"552",552,"PS312","LiCl",63,34,97,64,0.298969072164948,0.602484472049689
"553",553,"PS312","LiCl",34,30,64,100,0.0625,0.390243902439024
"554",554,"PS312","LiCl",69,26,95,106,0.452631578947368,0.472636815920398
"555",555,"PS312","LiCl",110,30,140,167,0.571428571428571,0.456026058631922
"556",556,"PS312","LiCl",87,33,120,190,0.45,0.387096774193548
"557",557,"PS312","LiCl",87,36,123,144,0.414634146341463,0.460674157303371
"558",558,"PS312","LiCl",54,32,86,150,0.255813953488372,0.364406779661017
"559",559,"PS312","LiCl",9,2,11,17,0.636363636363636,0.392857142857143
"560",560,"PS312","LiCl",8,2,10,15,0.6,0.4
"561",561,"PS312","LiCl",7,2,9,10,0.555555555555556,0.473684210526316
"562",562,"PS312","LiCl",7,1,8,9,0.75,0.470588235294118
"563",563,"PS312","LiCl",80,45,125,113,0.28,0.525210084033613
"564",564,"PS312","LiCl",94,45,139,114,0.352517985611511,0.549407114624506
"565",565,"PS312","LiCl",90,59,149,88,0.208053691275168,0.628691983122363
"566",566,"PS312","LiCl",120,51,171,136,0.403508771929825,0.55700325732899
"567",567,"PS312","LiCl",13,15,28,79,-0.0714285714285714,0.261682242990654
"568",568,"PS312","LiCl",15,7,22,70,0.363636363636364,0.239130434782609
"569",569,"PS312","LiCl",12,1,13,63,0.846153846153846,0.171052631578947
"570",570,"PS312","LiCl",19,11,30,105,0.266666666666667,0.222222222222222
"571",571,"PS312","LiCl",28,11,39,90,0.435897435897436,0.302325581395349
"572",572,"PS312","LiCl",7,10,17,58,-0.176470588235294,0.226666666666667
"573",573,"PS312","LiCl",7,4,11,42,0.272727272727273,0.207547169811321
"574",574,"PS312","LiCl",9,4,13,33,0.384615384615385,0.282608695652174
"575",575,"PS312","LiCl",13,9,22,64,0.181818181818182,0.255813953488372
"576",576,"PS312","LiCl",8,2,10,40,0.6,0.2
"577",577,"PS312","LiCl",55,10,65,118,0.692307692307692,0.355191256830601
"578",578,"PS312","LiCl",45,14,59,141,0.525423728813559,0.295
"579",579,"PS312","LiCl",49,16,65,97,0.507692307692308,0.401234567901235
"580",580,"PS312","LiCl",42,19,61,128,0.377049180327869,0.322751322751323
"581",581,"PS312","LiCl",16,5,21,41,0.523809523809524,0.338709677419355
"582",582,"PS312","LiCl",19,6,25,39,0.52,0.390625
"583",583,"PS312","LiCl",18,14,32,58,0.125,0.355555555555556
"584",584,"PS312","LiCl",16,3,19,71,0.684210526315789,0.211111111111111
"585",585,"PS312","LiCl",11,4,15,85,0.466666666666667,0.15
"586",586,"PS312","LiCl",16,4,20,100,0.6,0.166666666666667
"587",587,"PS312","LiCl",22,1,23,97,0.91304347826087,0.191666666666667
"588",588,"PS312","LiCl",17,4,21,97,0.619047619047619,0.177966101694915
"589",589,"PS312","LiCl",13,15,28,79,-0.0714285714285714,0.261682242990654
"590",590,"PS312","LiCl",15,7,22,70,0.363636363636364,0.239130434782609
"591",591,"PS312","LiCl",12,1,13,63,0.846153846153846,0.171052631578947
"592",592,"PS312","LiCl",19,11,30,105,0.266666666666667,0.222222222222222
"593",593,"PS312","LiCl",28,11,39,90,0.435897435897436,0.302325581395349
"594",594,"PS312","LiCl",38,5,43,130,0.767441860465116,0.248554913294798
"595",595,"PS312","LiCl",37,17,54,123,0.37037037037037,0.305084745762712
"596",596,"PS312","LiCl",11,4,15,32,0.466666666666667,0.319148936170213
"597",597,"PS312","LiCl",45,3,48,67,0.875,0.417391304347826
"598",598,"PS312","LiCl",24,9,33,69,0.454545454545455,0.323529411764706
"599",599,"PS312","LiCl",22,11,33,50,0.333333333333333,0.397590361445783
"600",600,"csu79","LiCl",20,4,24,50,0.666666666666667,0.324324324324324
"601",601,"csu79","LiCl",23,15,38,68,0.210526315789474,0.358490566037736
"602",602,"csu79","LiCl",16,15,31,50,0.032258064516129,0.382716049382716
"603",603,"csu79","LiCl",14,4,18,39,0.555555555555556,0.315789473684211
"604",604,"csu79","LiCl",26,16,42,55,0.238095238095238,0.43298969072165
"605",605,"csu79","LiCl",30,6,36,67,0.666666666666667,0.349514563106796
"606",606,"csu79","LiCl",23,28,51,71,-0.0980392156862745,0.418032786885246
"607",607,"csu79","LiCl",11,15,26,56,-0.153846153846154,0.317073170731707
"608",608,"csu79","LiCl",6,11,17,38,-0.294117647058824,0.309090909090909
"609",609,"csu79","LiCl",14,4,18,41,0.555555555555556,0.305084745762712
"610",610,"csu79","LiCl",9,24,33,63,-0.454545454545455,0.34375
"611",611,"csu79","LiCl",21,2,23,78,0.826086956521739,0.227722772277228
"612",612,"csu79","LiCl",15,4,19,122,0.578947368421053,0.134751773049645
"613",613,"csu79","LiCl",22,2,24,119,0.833333333333333,0.167832167832168
"614",614,"csu79","LiCl",16,6,22,144,0.454545454545455,0.132530120481928
"615",615,"csu79","LiCl",11,2,13,102,0.692307692307692,0.11304347826087
"616",616,"csu79","LiCl",14,0,14,104,1,0.11864406779661
"617",617,"csu80","LiCl",35,13,48,21,0.458333333333333,0.695652173913043
"618",618,"csu80","LiCl",82,39,121,90,0.355371900826446,0.57345971563981
"619",619,"csu80","LiCl",35,22,57,80,0.228070175438596,0.416058394160584
"620",620,"csu80","LiCl",39,35,74,116,0.0540540540540541,0.389473684210526
"621",621,"csu80","LiCl",31,6,37,64,0.675675675675676,0.366336633663366
"622",622,"csu80","LiCl",13,4,17,33,0.529411764705882,0.34
"623",623,"csu80","LiCl",46,11,57,102,0.614035087719298,0.358490566037736
"624",624,"csu80","LiCl",22,15,37,85,0.189189189189189,0.30327868852459
"625",625,"csu80","LiCl",28,29,57,37,-0.0175438596491228,0.606382978723404
"626",626,"csu80","LiCl",25,14,39,39,0.282051282051282,0.5
"627",627,"csu80","LiCl",11,0,11,NA,1,NA
"628",628,"csu80","LiCl",10,3,13,NA,0.538461538461538,NA
"629",629,"csu80","LiCl",14,4,18,NA,0.555555555555556,NA
"630",630,"csu80","LiCl",13,1,14,NA,0.857142857142857,NA
"631",631,"che-1 #1","LiCl",81,48,129,150,0.255813953488372,0.462365591397849
"632",632,"che-1 #1","LiCl",89,53,142,150,0.253521126760563,0.486301369863014
"633",633,"che-1 #1","LiCl",55,50,105,165,0.0476190476190476,0.388888888888889
"634",634,"che-1 #1","LiCl",70,54,124,200,0.129032258064516,0.382716049382716
"635",635,"che-1 #1","LiCl",27,19,46,144,0.173913043478261,0.242105263157895
"636",636,"che-1 #1","LiCl",27,11,38,162,0.421052631578947,0.19
"637",637,"che-1 #1","LiCl",29,20,49,129,0.183673469387755,0.275280898876405
"638",638,"che-1 #1","LiCl",27,17,44,136,0.227272727272727,0.244444444444444
"639",639,"che-1 #1","LiCl",58,17,75,111,0.546666666666667,0.403225806451613
"640",640,"che-1 #1","LiCl",71,12,83,90,0.710843373493976,0.479768786127168
"641",641,"che-1 #1","LiCl",34,17,51,102,0.333333333333333,0.333333333333333
"642",642,"che-1 #1","LiCl",41,21,62,100,0.32258064516129,0.382716049382716
"643",643,"che-1 #1","LiCl",25,23,48,115,0.0416666666666667,0.294478527607362
"644",644,"che-1 #1","LiCl",18,13,31,69,0.161290322580645,0.31
"645",645,"che-1 #1","LiCl",19,10,29,83,0.310344827586207,0.258928571428571
"646",646,"che-1 #1","LiCl",11,12,23,95,-0.0434782608695652,0.194915254237288
"647",647,"che-1 #2","LiCl",50,42,92,156,0.0869565217391304,0.370967741935484
"648",648,"che-1 #2","LiCl",70,36,106,120,0.320754716981132,0.469026548672566
"649",649,"che-1 #2","LiCl",23,14,37,72,0.243243243243243,0.339449541284404
"650",650,"che-1 #2","LiCl",69,36,105,150,0.314285714285714,0.411764705882353
"651",651,"che-1 #2","LiCl",92,81,173,181,0.0635838150289017,0.488700564971751
"652",652,"che-1 #2","LiCl",92,62,154,195,0.194805194805195,0.441260744985673
"653",653,"che-1 #2","LiCl",71,52,123,170,0.154471544715447,0.419795221843003
"654",654,"che-1 #2","LiCl",58,36,94,150,0.234042553191489,0.385245901639344
"655",655,"che-1 #2","LiCl",9,6,15,36,0.2,0.294117647058824
"656",656,"che-1 #2","LiCl",18,5,23,53,0.565217391304348,0.302631578947368
"657",657,"che-1 #2","LiCl",34,11,45,90,0.511111111111111,0.333333333333333
"658",658,"che-1 #2","LiCl",31,12,43,63,0.441860465116279,0.405660377358491
"659",659,"che-1 #2","LiCl",28,18,46,96,0.217391304347826,0.323943661971831
"660",660,"che-1 #2","LiCl",51,47,98,132,0.0408163265306122,0.426086956521739
"661",661,"che-1 #2","LiCl",47,34,81,130,0.160493827160494,0.383886255924171
"662",662,"che-1 #2","LiCl",45,29,74,146,0.216216216216216,0.336363636363636
"663",663,"mok83","LiCl",3,8,11,47,-0.454545454545455,0.189655172413793
"664",664,"mok83","LiCl",3,12,15,51,-0.6,0.227272727272727
"665",665,"mok83","LiCl",3,7,10,56,-0.4,0.151515151515152
"666",666,"mok83","LiCl",1,18,19,39,-0.894736842105263,0.327586206896552
"667",667,"mok83","LiCl",11,11,22,52,0,0.297297297297297
"668",668,"mok83","LiCl",15,13,28,47,0.0714285714285714,0.373333333333333
"669",669,"mok83","LiCl",8,6,14,23,0.142857142857143,0.378378378378378
"670",670,"mok83","LiCl",5,4,9,34,0.111111111111111,0.209302325581395
"671",671,"mok83","LiCl",16,8,24,47,0.333333333333333,0.338028169014085
"672",672,"mok83","LiCl",4,10,14,44,-0.428571428571429,0.241379310344828
"673",673,"mok83","LiCl",11,14,25,72,-0.12,0.257731958762887
"674",674,"mok83","LiCl",12,7,19,48,0.263157894736842,0.283582089552239
"675",675,"mok83","LiCl",14,6,20,20,0.4,0.5
"676",676,"mok83","LiCl",6,6,12,43,0,0.218181818181818
"677",677,"mok84","LiCl",7,13,20,50,-0.3,0.285714285714286
"678",678,"mok84","LiCl",15,10,25,58,0.2,0.301204819277108
"679",679,"mok84","LiCl",18,29,47,48,-0.234042553191489,0.494736842105263
"680",680,"mok84","LiCl",12,16,28,43,-0.142857142857143,0.394366197183099
"681",681,"mok84","LiCl",16,16,32,79,0,0.288288288288288
"682",682,"mok84","LiCl",19,17,36,61,0.0555555555555556,0.371134020618557
"683",683,"mok84","LiCl",18,6,24,44,0.5,0.352941176470588
"684",684,"mok84","LiCl",14,4,18,38,0.555555555555556,0.321428571428571
"685",685,"mok84","LiCl",2,8,10,44,-0.6,0.185185185185185
"686",686,"mok84","LiCl",23,17,40,86,0.15,0.317460317460317
"687",687,"mok84","LiCl",19,12,31,45,0.225806451612903,0.407894736842105
"688",688,"mok84","LiCl",31,15,46,74,0.347826086956522,0.383333333333333
"689",689,"mok84","LiCl",7,10,17,45,-0.176470588235294,0.274193548387097
"690",690,"mok84","LiCl",26,23,49,74,0.0612244897959184,0.398373983739837
"691",691,"mok59","LiCl",4,6,10,23,-0.2,0.303030303030303
"692",692,"mok59","LiCl",3,6,9,29,-0.333333333333333,0.236842105263158
"693",693,"mok59","LiCl",7,2,9,25,0.555555555555556,0.264705882352941
"694",694,"mok59","LiCl",8,8,16,16,0,0.5
"695",695,"mok59","LiCl",4,8,12,34,-0.333333333333333,0.260869565217391
"696",696,"mok59","LiCl",6,4,10,16,0.2,0.384615384615385
"697",697,"mok59","LiCl",10,16,26,24,-0.230769230769231,0.52
"698",698,"mok59","LiCl",8,4,12,25,0.333333333333333,0.324324324324324
"699",699,"mok59","LiCl",5,7,12,47,-0.166666666666667,0.203389830508475
"700",700,"mok59","LiCl",3,6,9,28,-0.333333333333333,0.243243243243243
"701",701,"mok59","LiCl",23,9,32,77,0.4375,0.293577981651376
"702",702,"mok59","LiCl",5,9,14,34,-0.285714285714286,0.291666666666667
"703",703,"PS312","NaCl",32,27,59,103,0.0847457627118644,0.364197530864198
"704",704,"PS312","NaCl",24,29,53,59,-0.0943396226415094,0.473214285714286
"705",705,"PS312","NaCl",38,35,73,81,0.0410958904109589,0.474025974025974
"706",706,"PS312","NaCl",54,39,93,95,0.161290322580645,0.49468085106383
"707",707,"PS312","NaCl",42,23,65,121,0.292307692307692,0.349462365591398
"708",708,"PS312","NaCl",25,34,59,71,-0.152542372881356,0.453846153846154
"709",709,"PS312","NaCl",28,16,44,46,0.272727272727273,0.488888888888889
"710",710,"PS312","NaCl",24,12,36,36,0.333333333333333,0.5
"711",711,"PS312","NaCl",18,14,32,38,0.125,0.457142857142857
"712",712,"PS312","NaCl",13,4,17,33,0.529411764705882,0.34
"713",713,"PS312","NaCl",57,9,66,72,0.727272727272727,0.478260869565217
"714",714,"PS312","NaCl",51,14,65,81,0.569230769230769,0.445205479452055
"715",715,"PS312","NaCl",20,18,38,32,0.0526315789473684,0.542857142857143
"716",716,"PS312","NaCl",19,9,28,44,0.357142857142857,0.388888888888889
"717",717,"PS312","NaCl",10,2,12,14,0.666666666666667,0.461538461538462
"718",718,"PS312","NaCl",20,15,35,43,0.142857142857143,0.448717948717949
"719",719,"PS312","NaCl",5,7,12,39,-0.166666666666667,0.235294117647059
"720",720,"PS312","NaCl",9,8,17,52,0.0588235294117647,0.246376811594203
"721",721,"PS312","NaCl",6,4,10,30,0.2,0.25
"722",722,"PS312","NaCl",6,8,14,44,-0.142857142857143,0.241379310344828
"723",723,"PS312","NaCl",14,18,32,60,-0.125,0.347826086956522
"724",724,"PS312","NaCl",10,7,17,61,0.176470588235294,0.217948717948718
"725",725,"PS312","NaCl",27,13,40,56,0.35,0.416666666666667
"726",726,"PS312","NaCl",14,9,23,36,0.217391304347826,0.389830508474576
"727",727,"PS312","NaCl",10,1,11,27,0.818181818181818,0.289473684210526
"728",728,"PS312","NaCl",6,2,8,18,0.5,0.307692307692308
"729",729,"PS312","NaCl",19,8,27,75,0.407407407407407,0.264705882352941
"730",730,"PS312","NaCl",4,4,8,28,0,0.222222222222222
"731",731,"PS312","NaCl",9,2,11,25,0.636363636363636,0.305555555555556
"732",732,"PS312","NaCl",5,4,9,25,0.111111111111111,0.264705882352941
"733",733,"PS312","NaCl",7,3,10,30,0.4,0.25
"734",734,"PS312","NaCl",4,18,22,97,-0.636363636363636,0.184873949579832
"735",735,"PS312","NaCl",4,6,10,53,-0.2,0.158730158730159
"736",736,"PS312","NaCl",25,15,40,72,0.25,0.357142857142857
"737",737,"PS312","NaCl",16,19,35,103,-0.0857142857142857,0.253623188405797
"738",738,"PS312","NaCl",47,11,58,72,0.620689655172414,0.446153846153846
"739",739,"PS312","NaCl",54,31,85,138,0.270588235294118,0.381165919282511
"740",740,"PS312","NaCl",42,25,67,128,0.253731343283582,0.343589743589744
"741",741,"PS312","NaCl",82,31,113,129,0.451327433628319,0.466942148760331
"742",742,"PS312","NaCl",30,25,55,84,0.0909090909090909,0.39568345323741
"743",743,"PS312","NaCl",22,12,34,60,0.294117647058824,0.361702127659574
"744",744,"PS312","NaCl",61,23,84,127,0.452380952380952,0.398104265402844
"745",745,"PS312","NaCl",44,21,65,78,0.353846153846154,0.454545454545455
"746",746,"PS312","NaCl",33,14,47,73,0.404255319148936,0.391666666666667
"747",747,"PS312","NaCl",16,15,31,87,0.032258064516129,0.26271186440678
"748",748,"PS312","NaCl",29,10,39,68,0.487179487179487,0.364485981308411
"749",749,"PS312","NaCl",27,10,37,56,0.459459459459459,0.397849462365591
"750",750,"PS312","NaCl",25,15,40,62,0.25,0.392156862745098
"751",751,"PS312","NaCl",33,14,47,73,0.404255319148936,0.391666666666667
"752",752,"PS312","NaCl",11,4,15,37,0.466666666666667,0.288461538461538
"753",753,"PS312","NaCl",17,6,23,47,0.478260869565217,0.328571428571429
"754",754,"PS312","NaCl",26,7,33,63,0.575757575757576,0.34375
"755",755,"PS312","NaCl",17,10,27,58,0.259259259259259,0.317647058823529
"756",756,"PS312","NaCl",7,8,15,64,-0.0666666666666667,0.189873417721519
"757",757,"PS312","NaCl",15,5,20,42,0.5,0.32258064516129
"758",758,"PS312","NaCl",13,9,22,64,0.181818181818182,0.255813953488372
"759",759,"csu79","NaCl",26,4,30,105,0.733333333333333,0.222222222222222
"760",760,"csu79","NaCl",17,8,25,68,0.36,0.268817204301075
"761",761,"csu79","NaCl",19,5,24,78,0.583333333333333,0.235294117647059
"762",762,"csu79","NaCl",11,0,11,92,1,0.106796116504854
"763",763,"csu79","NaCl",15,2,17,82,0.764705882352941,0.171717171717172
"764",764,"csu79","NaCl",15,4,19,100,0.578947368421053,0.159663865546218
"765",765,"csu79","NaCl",14,0,14,64,1,0.179487179487179
"766",766,"csu79","NaCl",12,7,19,73,0.263157894736842,0.206521739130435
"767",767,"csu79","NaCl",11,9,20,55,0.1,0.266666666666667
"768",768,"csu79","NaCl",19,2,21,73,0.80952380952381,0.223404255319149
"769",769,"csu79","NaCl",15,8,23,39,0.304347826086957,0.370967741935484
"770",770,"csu79","NaCl",10,3,13,63,0.538461538461538,0.171052631578947
"771",771,"csu79","NaCl",12,7,19,66,0.263157894736842,0.223529411764706
"772",772,"csu79","NaCl",11,0,11,37,1,0.229166666666667
"773",773,"csu80","NaCl",42,19,61,65,0.377049180327869,0.484126984126984
"774",774,"csu80","NaCl",33,5,38,55,0.736842105263158,0.408602150537634
"775",775,"csu80","NaCl",50,17,67,92,0.492537313432836,0.421383647798742
"776",776,"csu80","NaCl",17,6,23,52,0.478260869565217,0.306666666666667
"777",777,"csu80","NaCl",14,6,20,56,0.4,0.263157894736842
"778",778,"csu80","NaCl",27,10,37,52,0.459459459459459,0.415730337078652
"779",779,"csu80","NaCl",58,25,83,69,0.397590361445783,0.546052631578947
"780",780,"csu80","NaCl",32,18,50,61,0.28,0.45045045045045
"781",781,"csu80","NaCl",15,5,20,39,0.5,0.338983050847458
"782",782,"csu80","NaCl",27,5,32,30,0.6875,0.516129032258065
"783",783,"csu80","NaCl",25,10,35,42,0.428571428571429,0.454545454545455
"784",784,"csu80","NaCl",33,9,42,41,0.571428571428571,0.506024096385542
"785",785,"csu80","NaCl",26,14,40,32,0.3,0.555555555555556
"786",786,"csu80","NaCl",25,12,37,37,0.351351351351351,0.5
"787",787,"che-1 #1","NaCl",19,13,32,81,0.1875,0.283185840707965
"788",788,"che-1 #1","NaCl",8,11,19,65,-0.157894736842105,0.226190476190476
"789",789,"che-1 #1","NaCl",8,10,18,75,-0.111111111111111,0.193548387096774
"790",790,"che-1 #1","NaCl",12,8,20,69,0.2,0.224719101123595
"791",791,"che-1 #1","NaCl",5,5,10,33,0,0.232558139534884
"792",792,"che-1 #1","NaCl",21,10,31,70,0.354838709677419,0.306930693069307
"793",793,"che-1 #1","NaCl",14,7,21,54,0.333333333333333,0.28
"794",794,"che-1 #1","NaCl",24,8,32,56,0.5,0.363636363636364
"795",795,"che-1 #1","NaCl",20,12,32,56,0.25,0.363636363636364
"796",796,"che-1 #1","NaCl",17,7,24,61,0.416666666666667,0.282352941176471
"797",797,"che-1 #1","NaCl",13,10,23,43,0.130434782608696,0.348484848484849
"798",798,"che-1 #1","NaCl",12,10,22,60,0.0909090909090909,0.268292682926829
"799",799,"che-1 #1","NaCl",11,5,16,59,0.375,0.213333333333333
"800",800,"che-1 #1","NaCl",16,16,32,97,0,0.248062015503876
"801",801,"che-1 #1","NaCl",10,6,16,54,0.25,0.228571428571429
"802",802,"che-1 #2","NaCl",10,10,20,52,0,0.277777777777778
"803",803,"che-1 #2","NaCl",17,23,40,75,-0.15,0.347826086956522
"804",804,"che-1 #2","NaCl",10,11,21,71,-0.0476190476190476,0.228260869565217
"805",805,"che-1 #2","NaCl",15,5,20,52,0.5,0.277777777777778
"806",806,"che-1 #2","NaCl",6,4,10,50,0.2,0.166666666666667
"807",807,"che-1 #2","NaCl",13,7,20,68,0.3,0.227272727272727
"808",808,"che-1 #2","NaCl",9,11,20,52,-0.1,0.277777777777778
"809",809,"che-1 #2","NaCl",14,10,24,45,0.166666666666667,0.347826086956522
"810",810,"che-1 #2","NaCl",4,5,9,33,-0.111111111111111,0.214285714285714
"811",811,"che-1 #2","NaCl",8,4,12,25,0.333333333333333,0.324324324324324
"812",812,"che-1 #2","NaCl",22,18,40,128,0.1,0.238095238095238
"813",813,"che-1 #2","NaCl",23,26,49,117,-0.0612244897959184,0.295180722891566
"814",814,"che-1 #2","NaCl",11,14,25,82,-0.12,0.233644859813084
"815",815,"che-1 #2","NaCl",13,5,18,50,0.444444444444444,0.264705882352941
"816",816,"che-1 #2","NaCl",16,17,33,77,-0.0303030303030303,0.3
"817",817,"mok83","NaCl",25,13,38,63,0.315789473684211,0.376237623762376
"818",818,"mok83","NaCl",17,5,22,40,0.545454545454545,0.354838709677419
"819",819,"mok83","NaCl",9,3,12,39,0.5,0.235294117647059
"820",820,"mok83","NaCl",6,6,12,31,0,0.27906976744186
"821",821,"mok83","NaCl",21,6,27,54,0.555555555555556,0.333333333333333
"822",822,"mok83","NaCl",9,10,19,45,-0.0526315789473684,0.296875
"823",823,"mok83","NaCl",3,6,9,35,-0.333333333333333,0.204545454545455
"824",824,"mok83","NaCl",14,7,21,38,0.333333333333333,0.355932203389831
"825",825,"mok83","NaCl",7,8,15,46,-0.0666666666666667,0.245901639344262
"826",826,"mok83","NaCl",19,18,37,55,0.027027027027027,0.402173913043478
"827",827,"mok83","NaCl",3,14,17,43,-0.647058823529412,0.283333333333333
"828",828,"mok83","NaCl",26,13,39,42,0.333333333333333,0.481481481481481
"829",829,"mok84","NaCl",14,13,27,82,0.037037037037037,0.247706422018349
"830",830,"mok84","NaCl",12,12,24,69,0,0.258064516129032
"831",831,"mok84","NaCl",8,11,19,70,-0.157894736842105,0.213483146067416
"832",832,"mok84","NaCl",23,13,36,60,0.277777777777778,0.375
"833",833,"mok84","NaCl",1,18,19,40,-0.894736842105263,0.322033898305085
"834",834,"mok84","NaCl",15,19,34,42,-0.117647058823529,0.447368421052632
"835",835,"mok84","NaCl",16,10,26,45,0.230769230769231,0.366197183098592
"836",836,"mok84","NaCl",6,13,19,60,-0.368421052631579,0.240506329113924
"837",837,"mok84","NaCl",15,21,36,60,-0.166666666666667,0.375
"838",838,"mok84","NaCl",26,17,43,73,0.209302325581395,0.370689655172414
"839",839,"mok84","NaCl",38,21,59,75,0.288135593220339,0.440298507462687
"840",840,"mok84","NaCl",34,17,51,71,0.333333333333333,0.418032786885246
"841",841,"mok59","NaCl",21,14,35,63,0.2,0.357142857142857
"842",842,"mok59","NaCl",14,10,24,54,0.166666666666667,0.307692307692308
"843",843,"mok59","NaCl",13,11,24,54,0.0833333333333333,0.307692307692308
"844",844,"mok59","NaCl",18,17,35,31,0.0285714285714286,0.53030303030303
"845",845,"mok59","NaCl",27,33,60,70,-0.1,0.461538461538462
"846",846,"mok59","NaCl",22,27,49,83,-0.102040816326531,0.371212121212121
"847",847,"mok59","NaCl",24,23,47,78,0.0212765957446809,0.376
"848",848,"mok59","NaCl",26,16,42,95,0.238095238095238,0.306569343065693
"849",849,"mok59","NaCl",11,11,22,50,0,0.305555555555556
"850",850,"mok59","NaCl",13,5,18,44,0.444444444444444,0.290322580645161
"851",851,"mok59","NaCl",8,8,16,32,0,0.333333333333333
"852",852,"mok59","NaCl",16,10,26,38,0.230769230769231,0.40625
"853",853,"PS312","NaAc",2,11,13,45,-0.692307692307692,0.224137931034483
"854",854,"PS312","NaAc",2,15,17,66,-0.764705882352941,0.204819277108434
"855",855,"PS312","NaAc",1,20,21,69,-0.904761904761905,0.233333333333333
"856",856,"PS312","NaAc",0,21,21,41,-1,0.338709677419355
"857",857,"PS312","NaAc",0,24,24,50,-1,0.324324324324324
"858",858,"PS312","NaAc",0,43,43,84,-1,0.338582677165354
"859",859,"PS312","NaAc",0,20,20,42,-1,0.32258064516129
"860",860,"PS312","NaAc",8,50,58,130,-0.724137931034483,0.308510638297872
"861",861,"PS312","NaAc",2,59,61,120,-0.934426229508197,0.337016574585635
"862",862,"PS312","NaAc",3,25,28,59,-0.785714285714286,0.32183908045977
"863",863,"PS312","NaAc",7,52,59,120,-0.76271186440678,0.329608938547486
"864",864,"PS312","NaAc",3,32,35,51,-0.828571428571429,0.406976744186047
"865",865,"PS312","NaAc",3,33,36,85,-0.833333333333333,0.297520661157025
"866",866,"PS312","NaAc",5,35,40,80,-0.75,0.333333333333333
"867",867,"PS312","NaAc",6,27,33,52,-0.636363636363636,0.388235294117647
"868",868,"PS312","NaAc",2,35,37,58,-0.891891891891892,0.389473684210526
"869",869,"PS312","NaAc",5,32,37,51,-0.72972972972973,0.420454545454545
"870",870,"PS312","NaAc",9,81,90,139,-0.8,0.393013100436681
"871",871,"PS312","NaAc",12,115,127,130,-0.811023622047244,0.494163424124514
"872",872,"PS312","NaAc",10,56,66,104,-0.696969696969697,0.388235294117647
"873",873,"PS312","NaAc",7,46,53,109,-0.735849056603774,0.327160493827161
"874",874,"PS312","NaAc",13,90,103,151,-0.747572815533981,0.405511811023622
"875",875,"PS312","NaAc",2,19,21,64,-0.80952380952381,0.247058823529412
"876",876,"PS312","NaAc",0,12,12,30,-1,0.285714285714286
"877",877,"PS312","NaAc",0,11,11,40,-1,0.215686274509804
"878",878,"PS312","NaAc",0,12,12,49,-1,0.19672131147541
"879",879,"PS312","NaAc",3,13,16,40,-0.625,0.285714285714286
"880",880,"PS312","NaAc",0,28,28,59,-1,0.32183908045977
"881",881,"PS312","NaAc",3,34,37,81,-0.837837837837838,0.313559322033898
"882",882,"PS312","NaAc",4,69,73,127,-0.89041095890411,0.365
"883",883,"PS312","NaAc",3,70,73,104,-0.917808219178082,0.412429378531073
"884",884,"PS312","NaAc",2,60,62,93,-0.935483870967742,0.4
"885",885,"PS312","NaAc",2,20,22,46,-0.818181818181818,0.323529411764706
"886",886,"PS312","NaAc",0,10,10,38,-1,0.208333333333333
"887",887,"PS312","NaAc",0,26,26,73,-1,0.262626262626263
"888",888,"PS312","NaAc",0,19,19,79,-1,0.193877551020408
"889",889,"PS312","NaAc",3,34,37,70,-0.837837837837838,0.345794392523364
"890",890,"PS312","NaAc",4,36,40,70,-0.8,0.363636363636364
"891",891,"PS312","NaAc",4,34,38,77,-0.789473684210526,0.330434782608696
"892",892,"PS312","NaAc",4,40,44,82,-0.818181818181818,0.349206349206349
"893",893,"PS312","NaAc",3,57,60,107,-0.9,0.359281437125749
"894",894,"PS312","NaAc",20,55,75,131,-0.466666666666667,0.364077669902913
"895",895,"PS312","NaAc",25,40,65,127,-0.230769230769231,0.338541666666667
"896",896,"PS312","NaAc",11,55,66,200,-0.666666666666667,0.24812030075188
"897",897,"PS312","NaAc",3,76,79,147,-0.924050632911392,0.349557522123894
"898",898,"PS312","NaAc",3,49,52,76,-0.884615384615385,0.40625
"899",899,"PS312","NaAc",4,29,33,91,-0.757575757575758,0.266129032258065
"900",900,"PS312","NaAc",13,75,88,129,-0.704545454545455,0.405529953917051
"901",901,"PS312","NaAc",19,73,92,97,-0.58695652173913,0.486772486772487
"902",902,"PS312","NaAc",9,47,56,93,-0.678571428571429,0.375838926174497
"903",903,"PS312","NaAc",8,40,48,82,-0.666666666666667,0.369230769230769
"904",904,"PS312","NaAc",21,43,64,129,-0.34375,0.33160621761658
"905",905,"PS312","NaAc",7,21,28,91,-0.5,0.235294117647059
"906",906,"PS312","NaAc",0,25,25,58,-1,0.301204819277108
"907",907,"PS312","NaAc",2,46,48,86,-0.916666666666667,0.358208955223881
"908",908,"PS312","NaAc",0,34,34,67,-1,0.336633663366337
"909",909,"PS312","NaAc",0,27,27,65,-1,0.293478260869565
"910",910,"PS312","NaAc",6,38,44,80,-0.727272727272727,0.354838709677419
"911",911,"PS312","NaAc",5,69,74,90,-0.864864864864865,0.451219512195122
"912",912,"PS312","NaAc",6,51,57,108,-0.789473684210526,0.345454545454545
"913",913,"PS312","NaAc",7,56,63,138,-0.777777777777778,0.313432835820896
"914",914,"PS312","NaAc",4,73,77,136,-0.896103896103896,0.36150234741784
"915",915,"PS312","NaAc",2,25,27,100,-0.851851851851852,0.21259842519685
"916",916,"PS312","NaAc",1,18,19,83,-0.894736842105263,0.186274509803922
"917",917,"PS312","NaAc",1,30,31,100,-0.935483870967742,0.236641221374046
"918",918,"PS312","NaAc",1,16,17,84,-0.882352941176471,0.168316831683168
"919",919,"PS312","NaAc",3,19,22,106,-0.727272727272727,0.171875
"920",920,"PS312","NaAc",2,12,14,76,-0.714285714285714,0.155555555555556
"921",921,"PS312","NaAc",6,18,24,78,-0.5,0.235294117647059
"922",922,"PS312","NaAc",0,22,22,60,-1,0.268292682926829
"923",923,"PS312","NaAc",4,33,37,72,-0.783783783783784,0.339449541284404
"924",924,"PS312","NaAc",3,48,51,86,-0.882352941176471,0.372262773722628
"925",925,"PS312","NaAc",6,31,37,79,-0.675675675675676,0.318965517241379
"926",926,"PS312","NaAc",11,63,74,120,-0.702702702702703,0.381443298969072
"927",927,"PS312","NaAc",3,12,15,72,-0.6,0.172413793103448
"928",928,"PS312","NaAc",1,32,33,63,-0.939393939393939,0.34375
"929",929,"PS312","NaAc",0,9,9,30,-1,0.230769230769231
"930",930,"PS312","NaAc",0,9,9,24,-1,0.272727272727273
"931",931,"csu79","NaAc",0,10,10,38,-1,0.208333333333333
"932",932,"csu79","NaAc",0,10,10,44,-1,0.185185185185185
"933",933,"csu79","NaAc",4,25,29,60,-0.724137931034483,0.325842696629214
"934",934,"csu79","NaAc",0,21,21,61,-1,0.25609756097561
"935",935,"csu79","NaAc",1,16,17,66,-0.882352941176471,0.204819277108434
"936",936,"csu79","NaAc",0,12,12,59,-1,0.169014084507042
"937",937,"csu79","NaAc",0,10,10,49,-1,0.169491525423729
"938",938,"csu79","NaAc",1,23,24,48,-0.916666666666667,0.333333333333333
"939",939,"csu79","NaAc",0,17,17,83,-1,0.17
"940",940,"csu79","NaAc",0,11,11,40,-1,0.215686274509804
"941",941,"csu79","NaAc",0,30,30,88,-1,0.254237288135593
"942",942,"csu79","NaAc",0,10,10,37,-1,0.212765957446809
"943",943,"csu79","NaAc",0,13,13,85,-1,0.13265306122449
"944",944,"csu79","NaAc",1,18,19,97,-0.894736842105263,0.163793103448276
"945",945,"csu79","NaAc",0,12,12,71,-1,0.144578313253012
"946",946,"csu79","NaAc",0,22,22,65,-1,0.252873563218391
"947",947,"csu80","NaAc",2,46,48,80,-0.916666666666667,0.375
"948",948,"csu80","NaAc",3,33,36,55,-0.833333333333333,0.395604395604396
"949",949,"csu80","NaAc",2,52,54,101,-0.925925925925926,0.348387096774194
"950",950,"csu80","NaAc",5,62,67,137,-0.850746268656716,0.32843137254902
"951",951,"csu80","NaAc",5,42,47,116,-0.787234042553192,0.288343558282209
"952",952,"csu80","NaAc",5,29,34,83,-0.705882352941177,0.290598290598291
"953",953,"csu80","NaAc",16,37,53,139,-0.39622641509434,0.276041666666667
"954",954,"csu80","NaAc",9,61,70,82,-0.742857142857143,0.460526315789474
"955",955,"csu80","NaAc",7,47,54,74,-0.740740740740741,0.421875
"956",956,"csu80","NaAc",1,16,17,54,-0.882352941176471,0.23943661971831
"957",957,"csu80","NaAc",1,30,31,46,-0.935483870967742,0.402597402597403
"958",958,"csu80","NaAc",1,17,18,37,-0.888888888888889,0.327272727272727
"959",959,"csu80","NaAc",0,18,18,40,-1,0.310344827586207
"960",960,"csu80","NaAc",0,26,26,54,-1,0.325
"961",961,"che-1 #1","NaAc",1,48,49,136,-0.959183673469388,0.264864864864865
"962",962,"che-1 #1","NaAc",4,51,55,132,-0.854545454545454,0.294117647058824
"963",963,"che-1 #1","NaAc",5,72,77,150,-0.87012987012987,0.33920704845815
"964",964,"che-1 #1","NaAc",7,74,81,137,-0.827160493827161,0.371559633027523
"965",965,"che-1 #1","NaAc",3,39,42,73,-0.857142857142857,0.365217391304348
"966",966,"che-1 #1","NaAc",3,29,32,121,-0.8125,0.209150326797386
"967",967,"che-1 #1","NaAc",0,27,27,80,-1,0.252336448598131
"968",968,"che-1 #1","NaAc",0,12,12,45,-1,0.210526315789474
"969",969,"che-1 #1","NaAc",1,10,11,48,-0.818181818181818,0.186440677966102
"970",970,"che-1 #1","NaAc",2,14,16,66,-0.75,0.195121951219512
"971",971,"che-1 #1","NaAc",0,18,18,65,-1,0.216867469879518
"972",972,"che-1 #1","NaAc",4,55,59,112,-0.864406779661017,0.345029239766082
"973",973,"che-1 #1","NaAc",4,38,42,100,-0.80952380952381,0.295774647887324
"974",974,"che-1 #1","NaAc",6,56,62,120,-0.806451612903226,0.340659340659341
"975",975,"che-1 #1","NaAc",2,44,46,115,-0.91304347826087,0.285714285714286
"976",976,"che-1 #1","NaAc",1,26,27,55,-0.925925925925926,0.329268292682927
"977",977,"che-1 #2","NaAc",3,56,59,77,-0.898305084745763,0.433823529411765
"978",978,"che-1 #2","NaAc",4,59,63,116,-0.873015873015873,0.35195530726257
"979",979,"che-1 #2","NaAc",1,30,31,58,-0.935483870967742,0.348314606741573
"980",980,"che-1 #2","NaAc",2,40,42,100,-0.904761904761905,0.295774647887324
"981",981,"che-1 #2","NaAc",3,27,30,75,-0.8,0.285714285714286
"982",982,"che-1 #2","NaAc",2,26,28,74,-0.857142857142857,0.274509803921569
"983",983,"che-1 #2","NaAc",2,21,23,63,-0.826086956521739,0.267441860465116
"984",984,"che-1 #2","NaAc",2,10,12,37,-0.666666666666667,0.244897959183673
"985",985,"che-1 #2","NaAc",2,21,23,79,-0.826086956521739,0.225490196078431
"986",986,"che-1 #2","NaAc",0,25,25,68,-1,0.268817204301075
"987",987,"che-1 #2","NaAc",0,41,41,89,-1,0.315384615384615
"988",988,"che-1 #2","NaAc",3,28,31,101,-0.806451612903226,0.234848484848485
"989",989,"che-1 #2","NaAc",3,34,37,92,-0.837837837837838,0.286821705426357
"990",990,"mok83","NaAc",24,12,36,52,0.333333333333333,0.409090909090909
"991",991,"mok83","NaAc",21,14,35,66,0.2,0.346534653465347
"992",992,"mok83","NaAc",31,14,45,44,0.377777777777778,0.50561797752809
"993",993,"mok83","NaAc",12,18,30,58,-0.2,0.340909090909091
"994",994,"mok83","NaAc",14,27,41,72,-0.317073170731707,0.36283185840708
"995",995,"mok83","NaAc",4,12,16,55,-0.5,0.225352112676056
"996",996,"mok83","NaAc",9,15,24,32,-0.25,0.428571428571429
"997",997,"mok83","NaAc",6,3,9,27,0.333333333333333,0.25
"998",998,"mok83","NaAc",36,12,48,61,0.5,0.440366972477064
"999",999,"mok83","NaAc",14,5,19,33,0.473684210526316,0.365384615384615
"1000",1000,"mok83","NaAc",17,6,23,46,0.478260869565217,0.333333333333333
"1001",1001,"mok83","NaAc",15,16,31,55,-0.032258064516129,0.36046511627907
"1002",1002,"mok84","NaAc",40,29,69,72,0.159420289855072,0.48936170212766
"1003",1003,"mok84","NaAc",26,19,45,62,0.155555555555556,0.420560747663551
"1004",1004,"mok84","NaAc",31,12,43,64,0.441860465116279,0.401869158878505
"1005",1005,"mok84","NaAc",46,18,64,94,0.4375,0.40506329113924
"1006",1006,"mok84","NaAc",31,14,45,60,0.377777777777778,0.428571428571429
"1007",1007,"mok84","NaAc",29,41,70,100,-0.171428571428571,0.411764705882353
"1008",1008,"mok84","NaAc",12,30,42,129,-0.428571428571429,0.245614035087719
"1009",1009,"mok84","NaAc",22,40,62,80,-0.290322580645161,0.436619718309859
"1010",1010,"mok84","NaAc",10,11,21,44,-0.0476190476190476,0.323076923076923
"1011",1011,"mok84","NaAc",15,25,40,67,-0.25,0.373831775700935
"1012",1012,"mok84","NaAc",14,10,24,45,0.166666666666667,0.347826086956522
"1013",1013,"mok84","NaAc",20,24,44,62,-0.0909090909090909,0.415094339622642
"1014",1014,"mok59","NaAc",3,7,10,24,-0.4,0.294117647058824
"1015",1015,"mok59","NaAc",11,8,19,19,0.157894736842105,0.5
"1016",1016,"mok59","NaAc",7,5,12,12,0.166666666666667,0.5
"1017",1017,"mok59","NaAc",9,11,20,20,-0.1,0.5
"1018",1018,"mok59","NaAc",16,15,31,71,0.032258064516129,0.303921568627451
"1019",1019,"mok59","NaAc",8,9,17,29,-0.0588235294117647,0.369565217391304
"1020",1020,"mok59","NaAc",13,4,17,59,0.529411764705882,0.223684210526316
"1021",1021,"mok59","NaAc",12,5,17,47,0.411764705882353,0.265625
"1022",1022,"mok59","NaAc",11,6,17,25,0.294117647058824,0.404761904761905
"1023",1023,"mok59","NaAc",9,5,14,41,0.285714285714286,0.254545454545455
"1024",1024,"mok59","NaAc",14,13,27,52,0.037037037037037,0.341772151898734
"1025",1025,"mok59","NaAc",12,12,24,43,0,0.358208955223881
"1026",1026,"mok59","NaAc",14,16,30,56,-0.0666666666666667,0.348837209302326
